17,13,13,13,13,13,13,13,13,13,13,13,13,13,13,13,13,13,13,18
11,08,08,08,08,08,08,08,08,08,08,08,08,08,08,08,08,08,08,22
11,08,08,08,08,08,08,08,08,08,08,08,08,08,08,08,08,08,08,22
11,08,08,08,00,00,00,08,08,08,08,08,08,08,08,08,08,08,08,22
11,08,08,08,00,00,00,08,08,08,08,08,08,08,08,08,08,08,08,22
11,08,08,08,08,08,08,08,08,08,08,08,08,08,08,08,08,08,08,22
11,08,08,08,08,08,08,08,08,08,08,08,08,08,08,08,08,08,08,22
11,08,08,08,08,08,08,08,15,10,08,08,08,08,08,08,08,08,08,22
11,08,08,08,08,08,08,08,14,12,08,08,08,08,08,08,08,08,08,22
11,08,08,08,08,08,08,08,08,08,08,08,08,08,08,08,08,08,08,22
11,08,08,08,08,08,08,08,08,08,08,08,08,08,08,08,08,08,08,22
11,08,08,08,08,08,08,08,08,08,08,08,08,08,08,08,08,08,08,22
11,08,08,08,08,08,08,08,08,08,08,08,08,08,08,08,08,08,08,22
11,08,08,08,08,08,08,08,08,08,08,08,08,08,08,08,08,08,08,22
11,08,08,08,08,08,08,08,08,08,08,08,08,08,08,08,08,08,08,22
11,08,08,08,08,08,08,08,08,08,08,08,08,08,08,08,08,08,08,22
11,08,08,08,08,08,08,08,08,08,08,08,08,08,08,08,08,08,08,22
11,08,08,08,08,08,08,08,08,08,08,08,08,08,08,08,08,08,08,22
11,08,08,08,08,08,08,08,08,08,08,08,08,08,08,08,08,08,08,22
11,08,08,08,08,08,08,08,08,08,08,08,08,08,08,08,08,08,08,22
11,08,08,08,08,08,08,08,08,08,08,08,08,08,08,08,08,08,08,22
11,08,08,08,08,08,08,08,08,08,08,08,08,08,08,08,08,08,08,22
11,08,08,08,08,08,08,08,08,08,08,08,08,08,08,08,08,08,08,22
11,08,08,08,08,08,08,08,08,08,08,08,08,08,08,08,08,08,08,22
16,09,09,09,09,09,09,09,09,09,09,09,09,09,09,09,09,09,09,19

1,1,1,1,1,1,1,1,1,1,1,1,1,1,1,1,1,1,1,1
1,0,0,0,0,0,0,0,0,0,0,0,0,0,0,0,0,0,0,1
1,0,0,0,0,0,0,0,0,0,0,0,0,0,0,0,0,0,0,1
1,0,0,0,0,0,0,0,0,0,0,0,0,0,0,0,0,0,0,1
1,0,0,0,0,0,0,0,0,0,0,0,0,0,0,0,0,0,0,1
1,0,0,0,0,0,0,0,0,0,0,0,0,0,0,0,0,0,0,1
1,0,0,0,0,0,0,0,0,0,0,0,0,0,0,0,0,0,0,1
1,0,0,0,0,0,0,0,0,0,0,0,0,0,0,0,0,0,0,1
1,0,0,0,0,0,0,0,0,0,0,0,0,0,0,0,0,0,0,1
1,0,0,0,0,0,0,0,0,0,0,0,0,0,0,0,0,0,0,1
1,0,0,0,0,0,0,0,0,0,0,0,0,0,0,0,0,0,0,1
1,0,0,0,0,0,0,0,0,0,0,0,0,0,0,0,0,0,0,1
1,0,0,0,0,0,0,0,0,0,0,0,0,0,0,0,0,0,0,1
1,0,0,0,0,0,0,0,0,0,0,0,0,0,0,0,0,0,0,1
1,0,0,0,0,0,0,0,0,0,0,0,0,0,0,0,0,0,0,1
1,0,0,0,0,0,0,0,0,0,0,0,0,0,0,0,0,0,0,1
1,0,0,0,0,0,0,0,0,0,0,0,0,0,0,0,0,0,0,1
1,0,0,0,0,0,0,0,0,0,0,0,0,0,0,0,0,0,0,1
1,0,0,0,0,0,0,0,0,0,0,0,0,0,0,0,0,0,0,1
1,0,0,0,0,0,0,0,0,0,0,0,0,0,0,0,0,0,0,1
1,0,0,0,0,0,0,0,0,0,0,0,0,0,0,0,0,0,0,1
1,0,0,0,0,0,0,0,0,0,0,0,0,0,0,0,0,0,0,1
1,0,0,0,0,0,0,0,0,0,0,0,0,0,0,0,0,0,0,1
1,0,0,0,0,0,0,0,0,0,0,0,0,0,0,0,0,0,0,1
1,1,1,1,1,1,1,1,1,1,1,1,1,1,1,1,1,1,1,1