17,13,13,13,13,13,13,13,13,13,13,13,13,13,13,13,13,13,13,18
11,08,08,08,08,08,40,08,08,08,08,08,08,08,08,08,08,08,08,21
11,08,08,08,08,08,40,40,08,08,08,08,08,08,08,08,08,08,08,21
11,08,08,08,00,34,00,40,40,08,08,08,08,08,08,08,08,08,08,21
11,08,08,30,30,32,00,40,40,08,08,08,08,08,08,08,08,08,08,21
11,08,08,08,08,08,08,40,08,08,08,08,08,08,08,08,08,08,08,21
11,08,08,08,08,08,08,08,08,08,08,08,08,08,08,08,08,08,08,21
11,08,08,08,08,08,08,08,15,20,10,08,08,08,08,08,08,08,08,21
11,08,08,08,08,08,08,08,21,50,11,08,08,08,08,08,08,08,08,21
11,08,08,08,08,08,08,08,14,13,12,08,08,08,08,08,08,08,08,21
11,08,08,08,08,08,08,08,08,08,08,08,08,08,08,08,08,08,08,21
11,08,08,08,08,08,08,08,08,08,08,08,08,08,08,08,08,08,08,21
11,08,08,08,08,08,08,08,08,08,08,08,08,08,08,08,08,08,08,21
11,08,08,08,08,08,08,08,08,08,08,08,08,08,08,08,08,08,08,21
11,08,08,08,08,08,08,08,08,08,08,08,08,08,08,08,08,08,08,21
11,08,08,08,08,08,08,08,08,08,08,08,08,08,08,08,08,08,08,21
11,08,08,08,08,08,08,08,08,08,08,08,08,08,08,08,08,08,08,21
11,08,08,08,08,08,08,08,08,08,08,08,08,08,08,08,08,08,08,21
11,08,08,08,08,08,08,08,08,08,08,08,08,08,08,08,08,08,08,21
11,08,08,08,08,08,08,08,08,08,08,08,08,08,08,08,08,08,08,21
11,08,08,08,08,08,08,08,08,08,08,08,08,08,08,08,08,08,08,21
11,08,08,08,08,08,08,08,08,08,08,08,08,08,08,08,08,08,08,21
11,08,08,08,08,08,08,08,08,08,08,08,08,08,08,08,08,08,08,21
11,08,08,08,08,08,08,08,08,08,08,08,08,08,08,08,08,08,08,21
16,20,20,20,20,20,20,20,20,20,20,20,20,20,20,20,20,20,20,19

1,1,1,1,1,1,1,1,1,1,1,1,1,1,1,1,1,1,1,1
1,0,0,0,0,0,0,0,0,0,0,0,0,0,0,0,0,0,0,1
1,0,0,0,0,0,0,0,0,0,0,0,0,0,0,0,0,0,0,1
1,0,0,0,0,0,0,0,0,0,0,0,0,0,0,0,0,0,0,1
1,0,0,0,0,0,0,0,0,0,0,0,0,0,0,0,0,0,0,1
1,0,0,0,0,0,0,0,0,0,0,0,0,0,0,0,0,0,0,1
1,0,0,0,0,0,0,0,0,0,0,0,0,0,0,0,0,0,0,1
1,0,0,0,0,0,0,0,0,0,0,0,0,0,0,0,0,0,0,1
1,0,0,0,0,0,0,0,0,0,0,0,0,0,0,0,0,0,0,1
1,0,0,0,0,0,0,0,0,0,0,0,0,0,0,0,0,0,0,1
1,0,0,0,0,0,0,0,0,0,0,0,0,0,0,0,0,0,0,1
1,0,0,0,0,0,0,0,0,0,0,0,0,0,0,0,0,0,0,1
1,0,0,0,0,0,0,0,0,0,0,0,0,0,0,0,0,0,0,1
1,0,0,0,0,0,0,0,0,0,0,0,0,0,0,0,0,0,0,1
1,0,0,0,0,0,0,0,0,0,0,0,0,0,0,0,0,0,0,1
1,0,0,0,0,0,0,0,0,0,0,0,0,0,0,0,0,0,0,1
1,0,0,0,0,0,0,0,0,0,0,0,0,0,0,0,0,0,0,1
1,0,0,0,0,0,0,0,0,0,0,0,0,0,0,0,0,0,0,1
1,0,0,0,0,0,0,0,0,0,0,0,0,0,0,0,0,0,0,1
1,0,0,0,0,0,0,0,0,0,0,0,0,0,0,0,0,0,0,1
1,0,0,0,0,0,0,0,0,0,0,0,0,0,0,0,0,0,0,1
1,0,0,0,0,0,0,0,0,0,0,0,0,0,0,0,0,0,0,1
1,0,0,0,0,0,0,0,0,0,0,0,0,0,0,0,0,0,0,1
1,0,0,0,0,0,0,0,0,0,0,0,0,0,0,0,0,0,0,1
1,1,1,1,1,1,1,1,1,1,1,1,1,1,1,1,1,1,1,1